"dota"
{
"addon_game_name"	"저주받은 콜로세움"
"[english]addon_game_name"	"Colosseum"
"addonname"	"저주받은 콜로세움"
"[english]addonname"	"Colosseum"
"conquest_subtitle"	"콜로세움"
"[english]conquest_subtitle"	"Colosseum"
"ConquestInstruction"	"5000"
"[english]ConquestInstruction"	"5000"
"Radiant_Team"	"래디언트"
"[english]Radiant_Team"	"RADIANT"
"Dire_Team"	"다이어"
"[english]Dire_Team"	"DIRE"
"Achievement_First"	"1000점 달성!"
"[english]Achievement_First"	"ACHIEVED 1000 POINTS!"
"Achievement_Second"	"2000점 달성!"
"[english]Achievement_Second"	"ACHIEVED 2000 POINTS!"
"Achievement_Third"	"3000점 달성!"
"[english]Achievement_Third"	"ACHIEVED 3000 POINTS!"
"Achievement_Fourth"	"4000점 달성!"
"[english]Achievement_Fourth"	"ACHIEVED 4000 POINTS!"
"Achievement_Fifth"	"남은 점수"
"[english]Achievement_Fifth"	"NEEDS LESS THAN"
"Reward_First_Radiant"	"다이어 거수가 나타났습니다!"
"[english]Reward_First_Radiant"	"A DIRE BEHEMOTH HAS SPAWNED!"
"Reward_Second_Radiant"	"다이어 거수들이 나타났습니다!"
"[english]Reward_Second_Radiant"	"DIRE BEHEMOTHS HAVE SPAWNED!"
"Reward_Third_Radiant"	"다이어 거수들이 나타났습니다!"
"[english]Reward_Third_Radiant"	"DIRE BEHEMOTHS HAVE SPAWNED!"
"Reward_Fourth_Radiant"	"다이어 거수들이 나타났습니다!"
"[english]Reward_Fourth_Radiant"	"DIRE BEHEMOTHS HAVE SPAWNED!"
"Reward_Fifth_Radiant"	"승리까지 100점 남았습니다!"
"[english]Reward_Fifth_Radiant"	"100 POINTS TO WIN!"
"Reward_First_Dire"	"래디언트 거수가 나타났습니다!"
"[english]Reward_First_Dire"	"A RADIANT BEHEMOTH HAS SPAWNED!"
"Reward_Second_Dire"	"래디언트 거수들이 나타났습니다!"
"[english]Reward_Second_Dire"	"RADIANT BEHEMOTHS HAVE SPAWNED!"
"Reward_Third_Dire"	"래디언트 거수들이 나타났습니다!"
"[english]Reward_Third_Dire"	"RADIANT BEHEMOTHS HAVE SPAWNED!"
"Reward_Fourth_Dire"	"래디언트 거수들이 나타났습니다!"
"[english]Reward_Fourth_Dire"	"RADIANT BEHEMOTHS HAVE SPAWNED!"
"Reward_Fifth_Dire"	"승리까지 100점 남았습니다!"
"[english]Reward_Fifth_Dire"	"100 POINTS TO WIN!"
"Radiant_Winning"	"래디언트 점수"
"[english]Radiant_Winning"	"RADIANT SCORE"
"Dire_Winning"	"다이어 점수"
"[english]Dire_Winning"	"DIRE SCORE"
"Radiant_Waypoint"	"래디언트 중간 지점 활성화"
"[english]Radiant_Waypoint"	"RADIANT WAYPOINT NOW ACTIVE"
"Dire_Waypoint"	"다이어 중간 지점 활성화"
"[english]Dire_Waypoint"	"DIRE WAYPOINT NOW ACTIVE"
"Waypoint_Active"	"중간 지점 활성화"
"[english]Waypoint_Active"	"WAYPOINTS NOW ACTIVE"
"CP1"	"1"
"[english]CP1"	"1"
"CP2"	"2"
"[english]CP2"	"2"
"CP3"	"3"
"[english]CP3"	"3"
"CP4"	"4"
"[english]CP4"	"4"
"CP5"	"5"
"[english]CP5"	"5"
"CP_Radiant"	"래디언트"
"[english]CP_Radiant"	"RADIANT"
"CP_Dire"	"다이어"
"[english]CP_Dire"	"DIRE"
"CP_Neutral"	"중립"
"[english]CP_Neutral"	"NEUTRAL"
"Radiant_Base"	"래디언트 기지"
"[english]Radiant_Base"	"RADIANT BASE"
"Dire_Base"	"다이어 기지"
"[english]Dire_Base"	"DIRE BASE"
"DOTA_Tooltip_ability_item_bag_of_gold"	"골드"
"[english]DOTA_Tooltip_ability_item_bag_of_gold"	"Gold"
"DOTA_Tooltip_ability_item_fountain_potion"	"활력"
"[english]DOTA_Tooltip_ability_item_fountain_potion"	"Rejuvenation"
"WP_Radiant"	"래디언트 중간 지점"
"[english]WP_Radiant"	"RADIANT WAYPOINT"
"WP_Dire"	"다이어 중간 지점"
"[english]WP_Dire"	"DIRE WAYPOINT"
"ConquestTeamPoints"	"점수"
"[english]ConquestTeamPoints"	"Points"
"custom_end_screen_victory_condition"	"가장 먼저 5000점 달성"
"[english]custom_end_screen_victory_condition"	"First to reach 5000 points"
"conquest_game_info_header_objective"	"목표:"
"[english]conquest_game_info_header_objective"	"Objective:"
"conquest_brief_description"	"두 팀이 지도 곳곳에 퍼져 있는 거점을 두고 싸웁니다. 세 거점을 점령하면 팀 점수를 얻습니다. 먼저 5000점을 획득하는 팀이 승리합니다."
"[english]conquest_brief_description"	"Two teams battle to capture the five Control Points located throughout the map.  Owning three Control Points will earn Team Points.  The first team to reach 5,000 Team Points will win the match."
"conquest_game_info_header_how_to_play"	"플레이 방법:"
"[english]conquest_game_info_header_how_to_play"	"How To Play:"
"conquest_game_info_control_point"	"영웅을 보내 <span class='control_point'>거점</span>을 차지하세요."
"[english]conquest_game_info_control_point"	"Move your hero onto a <span class='control_point'>Control Point</span> to capture it."
"conquest_game_info_control_point_rate"	"거점에 영웅이 더 많을수록 더 빠르게 점령할 수 있습니다."
"[english]conquest_game_info_control_point_rate"	"Having more heroes on a Control Point will capture it faster."
"conquest_game_info_team_points_1"	"세 곳의 거점을 차지하면 추가로 거점을 점령할 때마다 더 빠르게 <span class='team_points'>팀 점수</span>를 얻습니다."
"[english]conquest_game_info_team_points_1"	"Capturing additional Control Points beyond the third will cause your team to earn <span class='team_points'>Team Points</span> faster."
"conquest_game_info_team_points_2"	"팀이 1000점을 획득할 때마다 진행 단계가 활성화되어 상대 팀에 <span class='Behemoths'>거수</span>가 하나 이상 생성됩니다."
"[english]conquest_game_info_team_points_2"	"Every 1,000 Team Points a team earns will trigger a Milestone, causing their opponents to spawn one or more <span class='Behemoths'>Behemoths</span>."
"conquest_game_info_traps"	"지도 곳곳에 있는 <span class='fire_traps'>함정</span>을 이용해서 적들이 거점을 차지하지 못하도록 방해하세요."
"[english]conquest_game_info_traps"	"Use the <span class='fire_traps'>Traps</span> located throughout the map to keep your enemies from capturing Control Points."
"conquest_game_info_fire_traps"	"화염 함정, 맹독 함정, 추는 버튼으로 작동합니다. 지도에서 자기 팀 지역에 있는 버튼만 작동할 수 있습니다."
"[english]conquest_game_info_fire_traps"	"Fire Traps, Venom Traps, and the Pendulum are activated by buttons. Teams can only activate the buttons on their side of the map."
"conquest_game_info_spike_traps"	"가시 함정은 밟아서 작동시킵니다."
"[english]conquest_game_info_spike_traps"	"Spike Traps are activated by stepping on them."
"conquest_game_info_pendulum"	"추와 가시 함정은 작동시킨 팀 구분 없이 모든 영웅에게 피해를 줍니다."
"[english]conquest_game_info_pendulum"	"The Pendulum and Spike Traps will damage all heroes regardless of who activated them."
"conquest_game_info_fire_traps_2"	"화염 함정과 맹독 함정은 작동시킨 팀의 상대 팀 영웅에게만 피해를 줍니다."
"[english]conquest_game_info_fire_traps_2"	"Fire Traps and Venom Traps only damage enemies of the hero that activated them."
"conquest_game_info_tips_header"	"팁:"
"[english]conquest_game_info_tips_header"	"Tips:"
"conquest_game_info_tip01"	"거점에서 적을 상대하려면 팀 전투에 적합한 영웅을 선택하세요."
"[english]conquest_game_info_tip01"	"Choose heroes who work well in team fights to confront the enemy at Control Points."
"conquest_game_info_tip02"	"팀의 중간 지점을 이용하여 생성 지점에서 중앙 거점으로 이동할 수 있습니다."
"[english]conquest_game_info_tip02"	"Use your team's Waypoint to teleport from the spawn pool toward the central Control Point."
"conquest_game_info_tip03"	"영웅을 처치하면 활력 물약, 망고 주스, 동전이 떨어집니다."
"[english]conquest_game_info_tip03"	"Killing a hero will cause them to drop Rejuvenation Potions, Mango Juice, and Gold Coins."
"conquest_game_info_tip04"	"문양을 사용하면 일시적으로 모든 거점을 방어하고 적 팀이 점수를 얻지 못하게 막습니다. 중립 거점은 문양의 강화 효과를 받지 않습니다."
"[english]conquest_game_info_tip04"	"Using Glyph will temporarily block all Control Points from being captured, and from granting Team Points.  Glyph will not fortify neutral capture points."
"conquest_game_info_tip05"	"거수는 60초 동안 살아 있으며, 마법 피해에 면역이고 진실의 시야를 보유합니다."
"[english]conquest_game_info_tip05"	"Behemoths live 60 seconds, are immune to Magical Damage, and have True Sight."
"conquest_game_info_tip06"	"일부 영웅의 능력은 저주받은 콜로세움에 맞게 수정되었습니다."
"[english]conquest_game_info_tip06"	"Some hero abilities have been modified for Colosseum."
}
